XXXXXXXXXXXXXXX
XOOOOOOOOOOOXXX
XOXXXXXXXXXOXXX
XPXXXXXXXXXOXXX
XXXXXXXXXXXOXXX
XXXXXXXXOOOOXXX
XXXXXXXXOXXXXXX
XXXXXXXXOXXXXXX
XXXXXXXXGXXXXXX
XXXXXXXXXXXXXXX